{
  "1": {
    "idDoors" : [
      {"room" :  1, "door":  2},
      {"room" :  "", "door":  0}
    ],
    "image": "/assets/image/sprites/maps/1/1.png",
    "states" : [
      2,2,2,2,2,2,2,2,2,3,2,2,2,2,2,2,2,2,2,2,
      2,0,0,0,0,0,0,0,0,0,0,0,0,0,0,0,0,0,0,2,
      2,0,0,1,0,0,0,0,0,0,0,0,1,0,0,0,0,0,0,2,
      2,0,0,0,0,0,0,0,0,0,0,0,0,0,0,0,0,0,0,2,
      2,0,0,0,0,0,1,0,0,0,0,0,0,0,0,0,0,1,0,2,
      2,0,1,0,0,0,0,0,0,0,0,0,1,0,0,0,0,0,0,2,
      2,0,0,0,0,0,0,0,0,0,0,0,0,0,0,0,0,0,0,2,
      2,0,0,0,0,0,0,0,0,0,0,0,0,1,0,0,0,0,0,2,
      2,0,0,0,1,0,0,0,0,0,0,0,0,0,0,0,0,1,0,2,
      2,0,0,0,0,0,0,0,0,0,0,0,0,0,0,0,0,0,0,2,
      2,2,2,2,2,2,2,2,2,3,2,2,2,2,2,2,2,2,2,2
    ]
  },
  "2": {
    "idDoors" : [
      {"room" :  2, "door":  1},
      {"room" :  3, "door":  1},
      {"room" :  0, "door":  0}
    ],
    "image": "/assets/image/sprites/maps/1/2.png",
    "states" : [
      2,2,2,3,2,2,2,2,2,2,2,2,2,2,2,2,3,2,2,2,
      2,0,0,0,0,0,0,0,0,0,0,0,0,0,0,0,0,0,0,2,
      2,0,0,1,0,0,0,0,0,0,0,1,0,0,0,0,0,0,0,2,
      2,0,0,0,0,0,0,1,0,0,0,0,0,0,0,0,1,0,0,2,
      2,0,0,0,0,0,0,0,0,0,0,0,0,0,0,0,0,0,0,2,
      2,0,0,0,0,0,0,0,0,0,0,0,0,0,0,0,0,0,0,2,
      2,0,1,0,0,0,0,0,0,1,0,0,0,0,1,0,0,0,0,2,
      2,0,0,0,0,0,0,0,0,0,0,0,0,0,0,0,0,0,0,2,
      2,0,0,0,1,0,0,0,0,0,0,0,0,0,0,0,0,1,0,2,
      2,0,0,0,0,0,0,0,0,0,0,0,0,0,0,0,0,0,0,2,
      2,2,2,2,2,2,2,2,2,3,2,2,2,2,2,2,2,2,2,2
    ]
  },
  "3": {
    "idDoors" : [
      {"room" :  5, "door":  0},
      {"room" :  1, "door":  0}
    ],
    "image": "/assets/image/sprites/maps/1/3.png",
    "states" : [
      2,2,2,2,2,2,2,2,2,2,2,2,2,2,2,2,2,2,2,2,
      2,0,0,0,0,0,0,0,0,0,0,0,0,0,0,0,0,0,0,2,
      2,0,0,1,0,0,0,0,0,0,0,1,0,0,0,0,0,1,0,2,
      3,0,0,0,0,0,0,0,0,0,0,0,0,0,0,0,0,0,0,2,
      2,0,0,0,0,1,0,0,0,0,0,0,0,1,0,0,0,0,0,2,
      2,0,0,0,0,0,0,0,0,0,0,0,0,0,0,0,0,0,0,2,
      2,1,0,0,0,0,0,1,0,0,0,0,0,0,0,0,1,0,0,2,
      2,0,0,0,0,0,0,0,0,0,0,0,0,0,0,0,0,0,0,2,
      2,0,0,0,1,0,0,0,0,0,0,0,1,0,0,1,0,0,0,2,
      2,0,0,0,0,0,0,0,0,0,0,0,0,0,0,0,0,0,0,2,
      2,2,2,2,2,2,2,2,3,2,2,2,2,2,2,2,2,2,2,2
    ]
  },
  "4": {
    "idDoors" : [
      {"room" :  4, "door":  0},
      {"room" :  1, "door":  1}
    ],
    "image": "/assets/image/sprites/maps/1/4.png",
    "states" : [
      2,2,2,2,3,2,2,2,2,2,2,2,2,2,2,2,2,2,2,2,
      2,0,0,0,0,0,0,0,0,0,0,0,0,0,0,0,0,0,0,2,
      2,0,1,0,0,0,1,0,0,0,0,1,1,0,0,0,0,0,0,2,
      2,0,0,0,0,0,0,0,0,0,0,0,0,0,0,0,0,0,0,2,
      2,0,0,0,1,0,0,0,0,0,1,0,0,0,0,0,0,0,0,2,
      2,0,0,0,0,0,0,0,0,0,0,0,0,0,1,0,0,0,0,2,
      2,0,0,0,0,0,1,0,0,0,1,0,0,0,0,0,1,0,0,2,
      2,0,0,0,0,0,0,0,0,0,0,0,0,0,0,0,0,0,0,2,
      2,0,0,0,1,0,0,1,0,0,0,1,0,0,0,0,0,0,0,2,
      2,0,0,0,0,0,0,0,0,0,0,0,0,0,0,0,0,0,0,2,
      2,2,2,2,2,2,2,2,2,2,2,2,2,2,3,2,2,2,2,2
    ]
  },
  "5": {
    "idDoors" : [
      {"room" : 3, "door": 0}
    ],
    "image": "/assets/image/sprites/maps/1/5.png",
    "states" : [
      2,2,2,2,2,2,2,2,2,2,2,2,2,2,2,2,2,2,2,2,
      2,0,0,0,0,0,0,0,0,0,0,0,0,0,0,0,0,0,0,2,
      2,0,0,0,0,0,1,0,0,1,0,0,1,0,0,0,0,0,0,2,
      2,0,0,0,0,0,0,0,0,0,0,0,0,0,0,0,0,0,0,2,
      2,1,0,0,1,0,0,0,0,0,0,1,0,0,0,0,0,0,0,2,
      2,0,0,0,0,0,0,0,0,0,0,0,0,0,1,0,0,0,0,2,
      2,0,0,1,0,0,1,0,0,0,0,0,0,0,0,0,1,0,0,2,
      2,0,0,0,0,0,0,0,0,0,0,0,0,0,0,0,0,0,0,2,
      2,0,0,0,1,0,0,0,0,1,0,0,0,0,1,0,0,0,0,2,
      2,0,0,0,0,0,0,0,0,0,0,0,0,0,0,0,0,0,0,2,
      2,2,2,2,2,2,3,2,2,2,2,2,2,2,2,2,2,2,2,2
    ]
  },
  "6": {
    "idDoors" : [
      {"room" :  2, "door":  0}
    ],
    "image": "/assets/image/sprites/maps/1/6.png",
    "states" : [
      2,2,2,2,2,2,2,2,2,2,2,2,2,2,2,2,2,2,2,2,
      2,0,0,0,0,0,0,0,0,0,0,0,0,0,0,0,0,0,0,2,
      2,0,0,0,0,0,0,0,0,0,0,0,0,0,0,0,0,0,0,2,
      2,0,0,0,0,0,0,0,0,0,0,0,0,0,0,0,0,0,0,3,
      2,0,0,0,0,0,0,0,0,0,0,0,0,0,0,0,0,0,0,2,
      2,0,0,0,0,0,0,0,0,0,0,0,0,0,0,0,0,0,0,2,
      2,0,0,0,0,0,0,0,0,0,0,0,0,0,0,0,0,0,0,2,
      2,0,0,0,0,0,0,0,0,0,0,0,0,0,0,0,0,0,0,2,
      2,0,0,0,0,0,0,0,0,0,0,0,0,0,0,0,0,0,0,2,
      2,0,0,0,0,0,0,0,0,0,0,0,0,0,0,0,0,0,0,2,
      2,2,2,2,2,2,2,2,2,2,2,2,2,2,2,2,2,2,2,2
    ]
  }
}
