{
  "1": {
    "image": "/assets/image/sprites/maps/2/1.png",
    "states" : [
      2,2,2,2,2,2,2,2,2,2,2,2,2,2,2,2,2,2,2,2,
      2,0,0,0,0,0,0,0,0,0,0,0,0,0,0,0,0,0,0,2,
      3,0,0,1,0,0,0,0,0,0,0,0,0,0,1,0,0,0,0,2,
      2,0,0,0,0,0,0,0,0,0,0,0,0,0,0,0,0,0,0,2,
      2,0,0,0,0,0,1,0,0,0,0,0,0,0,0,0,0,0,0,2,
      2,0,0,0,0,0,0,0,0,0,0,0,0,0,0,0,0,0,0,2,
      2,0,0,0,0,0,0,0,0,0,0,1,0,0,0,0,0,0,0,2,
      2,0,1,0,0,0,0,0,0,0,0,0,0,0,0,0,0,0,0,2,
      2,0,0,0,0,0,0,0,0,0,0,0,0,0,0,0,1,0,0,2,
      2,0,0,0,0,0,1,0,0,0,0,0,0,0,0,0,0,0,0,2,
      2,2,2,2,2,2,2,2,3,2,2,2,2,2,2,2,2,2,2,2
    ]
  },
  "2": {
    "image": "/assets/image/sprites/maps/2/2.png",
    "states" : [
      2,2,2,2,2,2,2,2,2,2,2,2,2,2,2,2,2,2,2,2,
      2,0,0,0,0,0,0,0,0,0,0,0,0,1,0,0,0,1,0,2,
      2,0,0,1,0,0,0,0,0,0,0,0,0,0,0,0,0,0,0,3,
      3,0,0,0,0,0,1,0,0,0,1,0,0,0,0,0,0,0,0,2,
      2,0,0,0,0,0,0,0,0,0,0,0,0,0,0,0,0,0,0,2,
      2,0,0,0,0,0,0,0,1,0,0,0,0,0,0,0,0,0,0,2,
      2,0,0,0,0,0,0,0,0,0,0,0,0,0,0,0,0,0,0,2,
      2,0,0,0,0,0,1,0,0,0,1,0,0,0,0,0,0,0,0,2,
      2,1,0,0,0,0,0,0,0,0,0,0,0,0,0,0,1,0,0,2,
      2,0,0,0,0,0,0,0,0,0,1,0,0,0,0,0,0,0,0,2,
      2,2,2,2,2,2,2,2,2,3,2,2,2,2,2,2,2,2,2,2
    ]
  },
  "3": {
    "image": "/assets/image/sprites/maps/2/3.png",
    "states" : [
      2,2,2,2,2,2,2,2,2,3,2,2,2,2,2,2,2,2,2,2,
      2,1,0,0,0,0,0,0,0,0,0,0,0,0,0,0,0,0,0,2,
      2,0,0,1,0,0,0,0,0,0,0,0,0,0,0,1,0,0,0,2,
      2,0,0,0,0,0,0,0,0,0,1,0,0,0,0,0,0,0,0,2,
      2,0,0,0,0,0,0,0,0,0,0,0,0,0,0,0,0,1,0,2,
      2,0,0,0,1,0,0,0,0,0,0,0,0,0,0,0,0,0,0,2,
      2,0,0,0,0,0,0,0,0,0,0,0,0,0,1,0,0,0,0,2,
      2,0,0,0,0,0,0,0,0,0,0,0,0,0,0,0,0,0,0,2,
      2,1,0,0,0,0,0,0,0,0,0,0,0,0,0,0,0,0,0,2,
      2,0,0,0,0,1,0,0,0,0,0,1,0,0,0,0,1,0,0,2,
      2,2,2,2,2,2,2,2,2,2,2,2,2,2,2,2,2,2,2,2
    ]
  },
  "4": {
    "image": "/assets/image/sprites/maps/2/4.png",
    "states" : [
      2,2,2,2,2,2,2,3,2,2,2,2,2,2,2,2,2,2,2,2,
      2,0,0,0,0,0,0,0,0,0,0,0,0,0,0,0,0,0,0,2,
      2,0,0,0,1,0,0,0,0,0,1,0,0,0,0,1,0,0,0,3,
      2,0,0,0,0,0,0,0,0,0,0,0,0,0,0,0,0,0,0,2,
      2,0,0,0,0,0,0,0,0,0,1,0,0,0,0,0,0,0,0,2,
      2,0,0,0,1,0,0,0,0,0,0,0,0,0,0,0,0,0,0,2,
      2,0,0,0,0,0,0,0,0,0,0,0,0,1,0,0,0,0,0,2,
      2,1,0,0,0,0,0,0,0,1,0,0,0,0,0,0,0,0,0,2,
      2,0,0,0,1,0,0,0,0,0,0,0,0,0,0,0,0,0,0,2,
      2,0,0,0,0,0,0,1,0,0,0,0,0,0,0,0,1,0,0,2,
      2,2,2,2,2,3,2,2,2,2,2,2,2,2,2,2,2,2,2,2
    ]
  },
  "5": {
    "image": "/assets/image/sprites/maps/2/5.png",
    "states" : [
      2,2,2,2,2,2,2,2,2,2,2,2,2,2,2,2,2,2,2,2,
      2,0,0,0,0,0,0,0,0,0,0,1,0,0,0,0,0,0,0,2,
      2,0,0,0,1,0,0,0,0,0,0,0,0,0,0,1,0,0,0,2,
      2,0,0,0,0,0,0,0,0,0,1,0,0,0,0,0,0,0,0,2,
      2,0,1,0,0,0,0,0,0,0,0,0,0,0,0,0,0,0,0,2,
      2,0,0,0,0,0,0,1,0,0,0,0,0,1,0,0,0,0,0,2,
      2,0,0,0,0,0,0,0,0,0,1,0,0,0,0,1,0,0,0,2,
      2,1,0,0,0,0,0,0,0,0,0,0,0,0,0,0,0,0,0,2,
      2,0,0,0,1,0,0,0,0,0,0,1,0,0,0,0,0,0,0,2,
      2,0,0,0,0,0,0,0,0,0,0,0,0,0,0,0,0,0,0,2,
      2,2,2,2,2,3,2,2,2,2,2,2,2,2,2,2,2,2,2,2
    ]
  },
  "6": {
    "image": "/assets/image/sprites/maps/2/6.png",
    "states" : [
      2,2,2,2,2,2,2,3,2,2,2,2,2,2,2,2,2,2,2,2,
      2,1,0,0,0,0,0,0,0,0,0,1,0,1,0,0,0,0,0,2,
      2,0,0,0,0,0,0,0,0,0,0,0,0,0,0,1,0,0,0,2,
      2,0,0,0,0,0,0,0,0,0,0,0,0,0,0,0,0,0,0,2,
      3,0,0,0,0,1,0,0,0,0,0,0,0,0,0,0,0,0,1,2,
      2,0,0,0,0,0,0,1,0,0,0,0,0,1,0,0,0,0,0,2,
      2,1,0,0,0,0,0,0,0,0,0,0,0,0,0,0,1,0,0,2,
      2,0,0,0,0,0,0,0,0,0,0,0,0,0,0,0,0,0,0,2,
      2,0,0,0,1,0,0,1,0,0,0,1,0,0,0,0,0,0,0,2,
      2,0,0,0,0,0,0,0,0,0,0,0,0,0,0,0,0,1,0,2,
      2,2,2,2,2,2,2,2,2,2,2,2,2,2,2,2,2,2,2,2
    ]
  },
  "7": {
    "image": "/assets/image/sprites/maps/2/6.png",
    "states" : [
      2,2,2,2,2,2,2,2,2,2,2,2,2,2,2,2,2,2,2,2,
      2,0,0,0,0,1,0,0,0,0,0,1,0,1,0,0,0,1,0,2,
      2,0,0,0,0,0,0,0,0,0,0,0,0,0,0,0,0,0,0,2,
      2,1,0,0,0,0,0,0,1,0,0,0,0,0,0,0,0,0,0,2,
      2,0,0,0,0,0,0,0,0,0,0,0,1,0,0,0,0,0,1,2,
      2,0,0,0,0,1,0,0,0,0,0,0,0,0,0,0,0,0,0,2,
      2,1,0,0,0,0,0,0,0,0,0,0,0,0,0,0,0,0,0,3,
      2,0,0,0,0,0,0,0,0,0,0,0,0,0,0,1,0,0,0,2,
      2,0,0,0,0,0,0,0,0,0,0,1,0,0,0,0,0,0,0,2,
      2,0,0,1,0,0,0,0,0,0,0,0,0,0,0,0,0,1,0,2,
      2,2,2,2,2,2,3,2,2,2,2,2,2,2,2,2,2,2,2,2
    ]
  },
  "8": {
    "image": "/assets/image/sprites/maps/2/6.png",
    "states" : [
      2,2,2,2,2,2,2,2,2,3,2,2,2,2,2,2,2,2,2,2,
      2,0,0,0,0,0,0,0,0,0,0,0,0,0,0,0,0,0,0,2,
      2,0,0,0,0,0,0,0,0,0,0,0,0,0,0,0,0,0,0,2,
      2,0,0,0,0,0,0,0,0,0,0,0,0,0,0,0,0,0,0,2,
      2,0,0,0,0,0,0,0,0,0,0,0,0,0,0,0,0,0,0,2,
      2,0,0,0,0,0,0,0,0,0,0,0,0,0,0,0,0,0,0,2,
      2,0,0,0,0,0,0,0,0,0,0,0,0,0,0,0,0,0,0,2,
      2,0,0,0,0,0,0,0,0,0,0,0,0,0,0,0,0,0,0,2,
      2,0,0,0,0,0,0,0,0,0,0,0,0,0,0,0,0,0,0,2,
      2,0,0,0,0,0,0,0,0,0,0,0,0,0,0,0,0,0,0,2,
      2,2,2,2,2,2,2,2,2,2,2,2,2,2,2,2,2,2,2,2
    ]
  }
}